██████████████████████████████████████████████████████
█                        s                           █
██████ ███████████████████████████ ████████████████ ██
██████ ███████████████████████████ ███████████████   █
████                   ███                  ███ ██ ███
████████████████ █████████████████████████████████ ███
████████████████                 ███████            ██
████████████████ ██████████████ ████████ █████████ ███
███████████      ██████████████ ████████ █████████ ███
███████████ ████████     ██████          █████████   █
███████████ ████████ ███████████████ █████████████████
███████████ ████████ ███████████████          ████████
███                    █████████████ █████████████████
███ ██████████████ ███████████       █████████████████
███ ██████████████ ██████████████ ████████████████████
███ ██████████████ ██████████████ ████████████████████
███     ██████████ ███████                    ████████
██████ ███████████ ████████████████████ ██████████████
██████ ███████████ ████████████████████ ██████████████
██████ ███████████                 ████        ███████
██████ ███████████████████████████ ███████████ ███████
██████ ███████████████████████████ ███████████ ███    
████       ████           ███         ██       ███ ██ 
████████ ███████ ████████████████████ ██ █████████ ███
████████ ███████                      ██ ███          
████████ ███████ ██████████████ ████████ █████████ ███
████████ ██      █████ █████████████████ █████    ████
████████ ██ ████████        e██          █████████    
████████ ██ ████████ ███████████████ █████████████████
███████████ ████████ ███████████████      ████        
███                    █████████████ █████████████████
███ ██████████████ ███████████       █████████████████
███ ██████████████ ██████████████ ████████████████████
███ ██████████████ ██████████████ ████████████████████
███     ██████████ ███████                    ████████
██████████████████ ████████████████████ ██████████████
██████████████████ ████████████████████ ██████████████
██████████████████████████████████████████████████████